SO textures/pinkmarmol.png
NO textures/pinkmarmol.png
WE textures/pinkmarmol.png
EA textures/pinkmarmol.png

F 255,188,179
C 225,255,255

 11111 11111
100W001000001
 11000000011
   1100011
    11111 